NO assets/redbrick2.xpm
SO assets/greenbrick2.xpm
EA assets/bluebrick2.xpm
WE assets/yellowbrick2.xpm

F 195,189,240
C 20,20,20

        1111111111111111111111111
        1000000000110000000000001
        1011000001110000000000001
        1001000000000000000E00001
111111111011000001110000000000001
100000000011000001110111111111111
11110111111111011100000010001
11110111111111011101010010001
11000000110101011100000000001
10000000000000001100000000001
100000000000000011010100100011
1100000111010101111101111000111
11110111 1110101 1011110100011
11111111 1111111 111111111111